NO ./texture/mur1.xpm
SO ./texture/mur2.xpm
F 255,255,255
WE ./texture/mur3.xpm
EA ./texture/mur4.xpm
C 100, 0,0
          
              111111111111111111111111111111111111111111111111111111111
     1111111111111111100000000000000000000000000000011111111111
111111111111100000000000000000000000000000000000000000001
10000000000000000000000000000000000000000000000000000000111111
100000000000000011100000000000000000000000000000000000001
10000000000000001 10000000010000000000000000000000000000111
10000000000000001 10000000010000000000000000000000000000111
1000000000000000111000000001000000000000000000000000000010111111
1000000000000000000000000000000000000000000000000000000011100001
100000000000000000000000000000000000000000000000000000001 111111
111111111111111111111111111110111111111111111111111111111
111111111111111111111111111110111111111111111111111111111
100000000000000000000000000000000000000000000000000000001
100000000000000000000000000000000000000000000000000000001
100000000000000000000000000000000000000000000000000000001
1000000000000000000000000000000000000000000000W0000000001
100000000000000000000000000000000000000000000000000000001
111111111111111111111111111111111111111111111111111111111