SO ./texture/mur1.xpm
C 100, 0 ,0
NO ./texture/mur2.xpm
F 255, 255, 255
WE ./texture/mur3.xpm
EA ./texture/mur4.xpm

              111111111111111111111111111111111111111111111111111111111
     1111111111111111100000000000000000000000000000011111111111
111111111111100000000000000000000000000000000000000000001
10000000000000000000000000000000000000000000000000000000111111
1000000000000000111000000000000000000000000000000000000000001
10000000000000001 100000000100000000000000000000000000000111
10000000000000001 100000000100000000000000000000000000000000111
1000000000000000111000000001000000000000000000000000000010111111
100000000000000000000000000000000000000000000000000000001111
100000000000000000000000000000000000000000000000000000001 111111
111111111111111111111111111110111111111111111111111111111
111111111111111111111111111110111111111111111111111111111
100000000000000000000000000000000000000000000000000000001
100000000000000000000000000000000000000000000000000000001
100000000000000000000000000000000000000000000000000000001
1000000000000000000000000000000000000000000000N0000000001
100000000000000000000000000000000000000000000000000000001
111111111111111111111111111111111111111111111111111111111